
NO  ./texturs/space1.xpm  
SO  ./texturs/space3.xpm

WE  ./texturs/space6.xpm


EA  ./texturs/space4.xpm

F   30,30,30

C   75,75,75






                        11111111111
                         10000000001
                        10000000001
                         100000001
11111    111111111111111111000001
11111    111111111111111111000001
11111    111111111111111111000001
10001    100000000000000000000001
100111   10001111111111111000001       
10001    100000000000000001111111
 101      11111111000111011
11011    111111111000111101                           111111
100011111110000000000000001                          10000001
10001000011011111111111111111111111111111           1000000001     
1000000001101               1000000000001          100000000001
1000100001101               100000000000111111111110000000000001
100011111110111111          100000000000000000000000000000000001
100011111110111111          100000000000000000000000000000000001
100011000000000001          100000000000111111111110000000000001     
100011000000000001          1000000000001          100000000001
10001100000000000111111111111000000000001           1000000001
10001100000000000000000000000000011111111            10000001
1000110000000000011111111111110001                    111111
100001000000000001           10001
100000000001000001           10001
100001000000000001           10001
100011000000000001           10001
100011000000000001          10001               
100011000000000001         10001
100011000000000001        10001
100011111111111111       10001
10001            11111  10001
1001          11100000110001
101         110000000000001
101        10000000000000001
101       1000000000000000001111
101111111100000000000000000001101
1000000000000000000010000001011011
11111111110000000000010000000111101
          100000000000000001111111
           100000000S100001
            110000001000011
              11100000111
                 11111